- 0 = open space
- 1 = wall
- 2 = bush
- 3 = overworld entry/exit door
- 4 = inner doors
- 5 = key/requirement door

Grid name based on 4 points, in order.
- Dungeon
- Floor
- Y Coordinate
- X Coordinate

Add entry location text
Make every dungeon/grid have all 3 Arrays( Floor/level, X, Y )
Every grid as a seperate array, link together via:
grid = [overworld, dungeon1, dungeon2, dungeon3, etc...];

Dungeon array would be:
[
   [
      [1, 1, 1, 1, 1],
      [1, 0, 0, 0, 1],
      [1, 0, 0, 0, 1],
      [1, 0, 0, 0, 1],
      [1, 1, 1, 1, 1]
   ],
   [  
      [2, 2, 2, 2, 2],
      [2, 2, 2, 2, 2],
      [2, 2, 3, 2, 2],
      [2, 2, 2, 2, 2],
      [2, 2, 2, 2, 2]
   ]
]

to pinpoint the '3', it would be grid[1][2][2].
Dungeon 1 would be grid[0][1][2][2].

start Dungeon 1.
[^][<][<]
   [>][^]

[1, 1, 1, 1, 1, 1, 1, 1, 1, 1, 1],
[1, 0, 0, 0, 0, 0, 0, 0, 0, 0, 1],
[1, 0, 0, 0, boss, 0, 0, 0, 0, 1],
[1, 0, 0, 0, token,0, 0, 0, 0, 1],
[1, 0, 0, 0, 0, 0, 0, 0, 0, 0, 1],
[1, 0, 0, 0, 0, 0, 0, 0, 0, 0, 5],
[1, 0, 0, 0, 0, 0, 0, 0, 0, 0, 1],
[1, 0, 0, 0, 0, 0, 0, 0, 0, 0, 1],
[1, 0, 0, 0, 0, 0, 0, 0, 0, 0, 1],
[1, 0, 0, 0, 0, 0, 0, 0, 0, 0, 1],
[1, 1, 1, 1, 1, 1, 1, 1, 1, 1, 1];

Start Dungeon 2.
   [^]
[v][I][v]
[^][+][^]
   [^]
   
[1, 1, 1, 1, 1, 1, 1, 5, 1, 1, 1, 1, 1, 1, 1],
[1, 0, 0, 0, 0, 0, 0, 0, 0, 0, 0, 0, 0, 0, 1],
[1, 0, 0, 0, 0, 0, 0, 0, 0, 0, 0, 0, 0, 0, 1],
[1, 0, 0, 0, 0, 0, 0, 0, 0, 0, 0, 0, 0, 0, 1],
[1, 0, 0, 0, 0, 0, 0, 0, 0, 0, 0, 0, 0, 0, 1],
[1, 0, 0, 0, 0, 0, 0, 0, 0, 0, 0, 0, 0, 0, 1],
[1, 0, 0, 0, 0, 0, 0, 0, 0, 0, 0, 0, 0, 0, 1],
[1, 0, 0, 0, 0, 0, 0, 0, 0, 0, 0, 0, 0, 0, 1],
[1, 0, 0, 0, 0, 0, 0, 0, 0, 0, 0, 0, 0, 0, 1],
[1, 0, 0, 0, 0, 0, 0, 0, 0, 0, 0, 0, 0, 0, 1],
[1, 0, 0, 0, 0, 0, 0, 0, 0, 0, 0, 0, 0, 0, 1],
[1, 0, 0, 0, 0, 0, 0, 0, 0, 0, 0, 0, 0, 0, 1],
[1, 0, 0, 0, 0, 0, 0, 0, 0, 0, 0, 0, 0, 0, 1],
[1, 0, 0, 0, 0, 0, 0, 0, 0, 0, 0, 0, 0, 0, 1],
[1, 1, 1, 1, 1, 1, 1, 4, 1, 1, 1, 1, 1, 1, 1];

